************************
=----------------------=
=----==============----=
=----------****--------=
=------****------------=
=----==============----=
=----------------------=
************************